{
  "levelIndex": 3,
  "snoopyPosition": {
    "x": 4,
    "y": 3
  },
  "ball": {
    "x": 4,
    "y": 0
  },
  "blockPositions": [
    { "x": 1, "y": 1 },
    { "x": 1, "y": 6 },
    { "x": 7, "y": 6 },
    { "x": 7, "y": 1 },
    { "x": 4, "y": 1 },
    { "x": 3, "y": 2 },
    { "x": 2, "y": 3 },
    { "x": 2, "y": 4 },
    { "x": 3, "y": 5 },
    { "x": 4, "y": 7 },
    { "x": 5, "y": 2 },
    { "x": 5, "y": 5 },
    { "x": 6, "y": 4 },
    { "x": 6, "y": 3 }
  ],
  "birdPositions": [
    { "x": 0, "y": 0 },
    { "x": 0, "y": 7 },
    { "x": 8, "y": 0 },
    { "x": 8, "y": 7 }
  ]
}
